.....╔══════╗....║......
════╗║......║....║.█....
.╔══╬╝..╔═══╣...╗║.║....
═╣..║...║...╚═╦═╝╚╦╩════
.╚╦═╩═══╣.....║...║.....
..╚══...█.....╚═══╣.....
